107
9
15	0	0	0	0	0	0	0	0	0	0	0	0	0	0	0	0	0	0	0	0	0	0	0	0	0	0	0	0	0	0	0	0	0	0	0	0	0	0	0	0	0	0	15	15	15	15	15	15	15	15	15	15	15	15	15	15	15	15	15	15	15	15	15	15	15	15	15	15	15	15	15	15	15	15	15	0	0	0	0	0	0	0	0	0	0	0	0	0	0	15	15	15	15	15	15	15	15	15	15	15	15	15	15	15	15	15
15	0	0	0	0	0	0	0	0	0	0	0	0	0	0	0	0	0	0	0	0	0	0	0	0	0	0	0	0	0	0	0	0	0	0	0	0	0	0	0	0	0	0	0	15	15	15	15	15	15	15	15	15	15	15	15	15	15	15	15	15	15	15	15	15	15	15	15	15	15	15	15	15	15	15	15	0	0	0	0	0	0	0	0	0	0	0	0	0	0	0	15	15	15	15	15	15	15	15	15	15	15	15	15	15	15	15
15	0	0	0	0	0	0	0	0	0	0	0	14	0	0	0	0	0	14	0	0	0	0	0	0	0	0	0	0	0	0	0	0	0	0	0	0	0	0	0	15	0	0	0	0	15	15	15	15	15	15	15	15	15	15	15	15	15	15	15	15	0	0	0	0	0	0	0	0	0	0	15	15	15	15	15	0	0	0	0	0	0	0	0	0	0	0	0	0	0	0	0	15	15	15	15	15	15	0	0	0	0	0	0	0	15	15
15	0	0	0	0	0	0	0	0	0	0	0	0	0	0	16	0	0	0	0	0	0	0	0	0	0	0	0	0	0	0	0	0	0	15	0	0	0	0	15	15	15	0	0	0	0	0	0	0	15	15	15	15	15	15	15	15	15	15	15	0	0	15	0	15	0	0	0	0	0	0	0	0	15	15	0	0	0	0	15	0	0	0	0	15	15	15	0	0	0	0	0	0	15	15	15	15	15	0	0	0	0	0	0	0	15	15
15	0	0	0	0	0	0	0	0	0	0	0	16	16	16	16	16	0	0	0	0	0	0	0	0	0	0	15	0	0	0	0	0	15	15	0	0	0	0	0	0	0	0	0	0	15	15	0	0	0	0	0	0	0	0	0	0	0	0	0	0	15	15	15	15	15	0	0	0	0	0	0	0	0	0	0	0	0	0	15	15	15	0	0	15	15	15	0	0	0	0	0	0	0	15	15	15	15	0	0	0	0	0	0	0	15	15
15	3	10	0	12	4	5	6	11	0	16	16	16	16	16	16	16	0	0	0	0	0	15	15	0	0	0	0	0	0	15	0	0	0	0	0	0	15	0	0	0	0	0	15	15	15	15	15	15	0	0	0	0	0	0	0	0	0	0	0	0	15	15	15	15	15	0	0	0	0	0	0	0	0	0	0	0	0	0	0	0	0	0	0	15	15	15	0	0	0	0	0	0	0	0	0	0	0	0	0	0	0	0	0	0	15	15
15	2	0	0	0	7	8	9	0	16	16	16	16	16	16	16	16	0	0	0	15	15	15	15	15	15	0	0	15	15	15	15	15	0	15	15	15	15	15	0	0	0	0	15	15	15	15	15	15	15	0	15	15	15	0	0	15	15	15	15	15	15	15	15	15	15	0	0	0	0	0	0	0	15	0	0	15	15	0	0	15	0	0	15	15	15	15	15	0	0	0	0	0	0	0	0	0	0	0	15	15	0	0	15	0	15	15
15	15	15	15	16	16	16	16	16	16	16	16	16	16	16	16	16	0	0	0	15	15	15	15	15	15	15	15	15	15	15	15	15	15	15	15	15	15	15	0	0	0	0	15	15	15	15	15	15	15	15	15	15	15	15	15	15	15	15	15	15	15	15	15	15	15	0	0	0	0	0	15	15	15	15	15	15	15	15	15	15	15	15	15	15	15	15	15	15	15	15	15	15	15	15	15	15	15	15	15	15	15	15	15	15	15	15
17	17	17	17	17	17	17	17	17	17	17	17	17	17	17	17	17	17	17	17	17	17	17	17	17	17	17	17	17	17	17	17	17	17	17	17	17	17	17	17	17	17	17	17	17	17	17	17	17	17	17	17	17	17	17	17	17	17	17	17	17	17	17	17	17	17	17	17	17	17	17	17	17	17	17	17	17	17	17	17	17	17	17	17	17	17	17	17	17	17	17	17	17	17	17	17	17	17	17	17	17	17	17	17	17	17	17
