107
9
15	56	57	58	59	60	61	62	0	0	0	0	0	0	0	0	0	0	0	0	0	0	0	0	0	0	0	0	0	0	0	0	0	0	0	0	0	0	0	0	0	0	0	15	15	15	15	15	15	15	15	15	15	15	15	15	15	15	15	15	15	15	15	15	15	15	15	15	15	15	15	15	15	15	15	15	0	0	0	0	0	0	0	0	0	0	0	0	0	0	0	0	0	0	0	0	0	0	0	0	0	0	0	0	0	15	15
15	70	71	72	73	74	75	76	0	0	0	0	1	0	0	0	0	0	13	0	0	0	0	0	0	0	0	0	0	0	0	0	0	0	0	0	0	0	0	0	0	0	0	0	15	15	15	15	15	15	15	15	15	15	15	15	15	15	15	15	15	15	15	15	15	15	15	15	15	15	15	15	15	15	15	15	0	0	0	0	0	0	0	0	0	0	0	0	0	0	0	0	0	0	0	0	0	0	0	0	0	0	0	0	0	15	15
15	84	85	86	87	88	89	90	0	0	0	0	14	0	0	0	0	0	14	0	0	0	0	0	0	0	0	0	0	0	0	0	0	0	0	0	0	0	0	0	16	0	0	0	0	15	15	15	15	15	15	15	15	15	15	15	15	15	15	15	15	0	0	0	0	0	0	0	0	0	0	15	15	15	15	15	0	0	0	0	0	0	0	0	0	0	0	0	0	0	0	0	0	0	0	0	0	0	0	0	159	160	161	0	0	15	15
15	98	99	100	101	102	103	104	0	0	0	0	0	0	0	16	0	0	0	0	0	0	0	0	0	0	0	0	0	0	0	0	0	0	16	0	0	0	0	16	15	16	0	0	0	0	0	0	0	15	15	15	15	15	15	15	15	15	15	15	0	0	15	0	15	0	0	0	0	0	0	0	0	15	15	0	0	0	0	15	0	0	0	0	15	16	15	0	0	0	0	0	0	0	0	168	169	170	171	172	173	174	175	176	177	15	15
15	112	113	114	115	116	117	0	0	0	0	0	20	16	16	15	19	0	0	0	0	0	0	0	0	0	0	14	0	0	0	0	0	14	15	0	0	0	0	0	0	0	0	0	0	15	15	0	0	0	0	0	0	0	0	0	0	0	0	0	0	15	15	15	15	15	0	0	0	0	0	0	0	0	0	0	0	0	0	15	15	15	0	0	15	15	15	0	0	0	0	0	0	0	0	182	183	184	185	186	187	188	189	190	191	15	15
15	126	127	128	129	130	131	0	0	0	20	16	15	15	15	15	17	0	0	0	0	0	15	15	0	0	0	0	0	0	15	0	0	0	0	0	0	16	0	0	0	0	0	15	15	15	15	15	15	0	0	0	0	0	0	0	0	0	0	0	0	15	15	15	15	15	0	0	0	0	0	0	0	0	0	0	0	0	0	0	0	0	0	0	15	15	15	0	0	0	0	0	0	0	0	196	197	198	199	200	201	202	203	204	205	15	15
15	140	141	142	143	144	145	0	0	20	15	15	15	15	15	15	17	0	0	0	15	16	15	15	16	15	0	0	15	16	15	16	15	0	15	16	16	15	15	0	0	0	0	15	15	15	15	15	15	15	0	15	15	15	0	0	15	15	15	15	15	15	15	15	15	15	0	0	0	0	0	0	0	15	0	0	15	15	0	0	15	0	0	15	15	15	15	15	0	0	0	0	0	0	0	210	211	212	213	214	215	216	217	218	219	15	15
15	15	15	15	16	16	16	16	16	15	15	15	15	15	15	15	17	0	0	0	15	15	15	15	15	15	16	16	15	15	15	15	15	16	15	15	15	15	15	0	0	0	0	15	15	15	15	15	15	15	15	15	15	15	15	15	15	15	15	15	15	15	15	15	15	15	0	0	0	0	0	15	15	15	15	15	15	15	16	16	15	16	16	15	15	15	15	15	15	16	16	16	16	16	16	16	16	16	16	15	15	16	16	15	16	15	15
27	27	27	27	27	27	27	27	27	27	27	27	27	27	27	27	27	27	27	27	27	27	27	27	27	27	27	27	27	27	27	27	27	27	27	27	27	27	27	27	27	27	27	27	27	27	27	27	27	27	27	27	27	27	27	27	27	27	27	27	27	27	27	27	27	27	27	27	27	27	27	27	27	27	27	27	27	27	27	27	27	27	27	27	27	27	27	27	27	27	27	27	27	27	27	27	27	27	27	27	27	27	27	27	27	27	27
