107
9
14	0	0	0	0	0	0	0	0	0	0	0	0	0	0	0	0	0	0	0	0	0	0	0	0	0	0	0	0	0	0	0	0	0	0	0	0	0	0	0	0	0	0	14	14	14	14	14	14	14	14	14	14	14	14	14	14	14	14	14	14	14	14	14	14	14	14	14	14	14	14	14	14	14	14	14	0	0	0	0	0	0	0	0	0	0	0	0	0	0	14	14	14	14	14	14	14	14	14	14	14	14	14	14	14	14	14
14	0	0	0	0	0	0	0	0	0	0	0	0	0	0	0	0	0	0	0	0	0	0	0	0	0	0	0	0	0	0	0	0	0	0	0	0	0	0	0	0	0	0	0	14	14	14	14	14	14	14	14	14	14	14	14	14	14	14	14	14	14	14	14	14	14	14	14	14	14	14	14	14	14	14	14	0	0	0	0	0	0	0	0	0	0	0	0	0	0	0	14	14	14	14	14	14	14	14	14	14	14	14	14	14	14	14
14	0	0	0	0	0	0	0	0	0	0	0	13	0	0	0	0	0	13	0	0	0	0	0	0	0	0	0	0	0	0	0	0	0	0	0	0	0	0	0	14	0	0	0	0	14	14	14	14	14	14	14	14	14	14	14	14	14	14	14	14	0	0	14	0	0	0	0	0	0	0	14	14	14	14	14	0	0	0	0	0	0	0	0	0	0	0	0	0	0	0	0	14	14	14	14	14	14	0	0	0	0	0	0	0	14	14
14	0	0	0	0	0	0	0	0	0	0	0	0	0	0	15	0	0	0	0	0	0	0	0	0	0	0	0	0	0	0	0	0	0	14	0	0	0	0	14	14	14	0	0	0	0	0	0	0	14	14	14	14	14	14	14	14	14	14	14	0	0	14	0	14	0	0	0	0	0	0	0	0	14	14	0	0	0	0	14	0	0	0	0	14	14	14	0	0	0	0	0	0	14	14	14	14	14	0	0	0	0	0	0	0	14	14
14	0	0	0	0	0	0	0	0	0	0	0	15	15	15	15	15	0	0	0	0	0	0	0	0	0	0	14	0	0	0	0	0	14	14	0	0	0	0	0	0	0	0	0	0	14	14	0	0	0	0	0	14	14	14	14	14	14	14	0	0	14	14	14	14	14	0	0	0	0	0	0	0	0	0	0	0	0	0	14	14	14	0	0	14	14	14	0	0	0	0	0	0	0	14	14	14	14	0	0	0	0	0	0	0	14	14
14	3	10	0	12	4	5	6	11	0	15	15	15	15	15	15	15	0	0	0	0	0	14	14	0	0	0	0	0	0	14	0	0	0	0	0	0	14	0	0	0	0	0	14	14	14	14	14	14	0	0	0	14	0	0	0	0	14	0	0	0	14	14	14	14	14	0	0	0	0	0	0	0	0	0	0	0	0	0	0	0	0	0	0	14	14	14	0	0	0	0	0	0	0	0	14	14	0	0	0	0	0	0	0	0	14	14
14	2	0	0	0	7	8	9	0	15	15	15	15	15	15	15	15	0	0	0	14	14	14	14	14	14	0	0	14	14	14	14	14	0	14	14	14	14	14	0	0	0	0	14	14	14	14	14	14	14	0	14	14	14	0	0	14	14	14	14	14	14	14	14	14	14	0	0	0	0	0	0	0	14	0	0	14	14	0	0	14	0	0	14	14	14	14	14	0	0	0	0	0	0	0	0	0	0	0	14	14	0	0	14	0	14	14
14	14	14	14	15	15	15	15	15	15	15	15	15	15	15	15	15	0	0	0	14	14	14	14	14	14	14	14	14	14	14	14	14	14	14	14	14	14	14	0	0	0	0	14	14	14	14	14	14	14	14	14	14	14	14	14	14	14	14	14	14	14	14	14	14	14	0	0	0	0	0	14	14	14	14	14	14	14	14	14	14	14	14	14	14	14	14	14	14	14	14	14	14	14	14	14	14	14	14	14	14	14	14	14	14	14	14
16	16	16	16	16	16	16	16	16	16	16	16	16	16	16	16	16	16	16	16	16	16	16	16	16	16	16	16	16	16	16	16	16	16	16	16	16	16	16	16	16	16	16	16	16	16	16	16	16	16	16	16	16	16	16	16	16	16	16	16	16	16	16	16	16	16	16	16	16	16	16	16	16	16	16	16	16	16	16	16	16	16	16	16	16	16	16	16	16	16	16	16	16	16	16	16	16	16	16	16	16	16	16	16	16	16	16
